1111111
1000001
11101E1
1000111
10110C1
10P0011
1111111