1111111111111111111111
10000C1000C0001E000001
10011110C010C011110C01
1000P0000010C010000001
10000000001000C0000001
1111111111111111111111