1111111111
1000000001
10C0000C01
1000000001
1000P00001
1000000001
100E000001
100000C001
1000000001
1111111111